5 10
....KT....
..G....G..
...G..G...
..........
S.........
