10 10
SXX...XX..
..XXXXX...
...X......
......XTX.
..X..X....
..XXXX....
..XG...K..
..XXX.....
...K..XX..
..XX...XX.
